/*
 * Licensed to the Apache Software Foundation (ASF) under one or more
 * contributor license agreements.  See the NOTICE file distributed with
 * this work for additional information regarding copyright ownership.
 * The ASF licenses this file to you under the Apache License, Version 2.0
 * (the "License"); you may not use this file except in compliance with
 * the License.  You may obtain a copy of the License at
 *
 * http://www.apache.org/licenses/LICENSE-2.0
 *
 * Unless required by applicable law or agreed to in writing, software
 * distributed under the License is distributed on an "AS IS" BASIS,
 * WITHOUT WARRANTIES OR CONDITIONS OF ANY KIND, either express or implied.
 * See the License for the specific language governing permissions and
 * limitations under the License.
 */

AUTO: "AUTO"
ATTR: "ATTR"
ATTRS: "ATTRS"
AUTOTEMP: "AUTOTEMP"
BLOCKCOMPRESSION: "BLOCKCOMPRESSION"
BSON: "BSON"
BUT: "BUT"
BYTE: "BYTE"
BYTEINT: "BYTEINT"
BYTES: "BYTES"
CALLER: "CALLER"
CASE_N: "CASE_N"
CASESPECIFIC: "CASESPECIFIC"
CHECKSUM: "CHECKSUM"
CLIENT: "CLIENT"
COLOCATE: "COLOCATE"
COMPILE: "COMPILE"
COMPRESS: "COMPRESS"
CONCURRENT: "CONCURRENT"
CREATOR: "CREATOR"
CS: "CS"
CT: "CT"
DATABLOCKSIZE: "DATABLOCKSIZE"
DEL: "DEL"
DUAL: "DUAL"
FALLBACK: "FALLBACK"
FREESPACE: "FREESPACE"
GRAPHIC: "GRAPHIC"
HELP: "HELP"
HIGH: "HIGH"
INDEX: "INDEX"
INLINE: "INLINE"
INS: "INS"
ISOLATED: "ISOLATED"
JOURNAL: "JOURNAL"
KANJI1: "KANJI1"
KANJISJIS: "KANJISJIS"
KBYTES: "KBYTES"
KILOBYTES: "KILOBYTES"
LATIN: "LATIN"
LOADING: "LOADING"
LOG: "LOG"
LOW: "LOW"
MACRO: "MACRO"
MANUAL: "MANUAL"
MAXIMUM: "MAXIMUM"
MEDIUM: "MEDIUM"
MERGEBLOCKRATIO: "MERGEBLOCKRATIO"
MINIMUM: "MINIMUM"
NAMED: "NAMED"
NEVER: "NEVER"
OFF: "OFF"
OWNER: "OWNER"
PROTECTION: "PROTECTION"
QUALIFY: "QUALIFY"
RANGE_N: "RANGE_N"
RENAME: "RENAME"
REQUEST: "REQUEST"
SEL: "SEL"
SEMI: "SEMI"
STORAGE: "STORAGE"
SPL: "SPL"
SUBSTR: "SUBSTR"
TEMP: "TEMP"
TITLE: "TITLE"
TOP: "TOP"
TRANSLATE_CHK: "TRANSLATE_CHK"
UBJSON: "UBJSON"
UNICODE: "UNICODE"
UPD: "UPD"
UPPERCASE: "UPPERCASE"
VARBYTE: "VARBYTE"
VOLATILE: "VOLATILE"
WARNING: "WARNING"
