/*
 * Licensed to the Apache Software Foundation (ASF) under one or more
 * contributor license agreements.  See the NOTICE file distributed with
 * this work for additional information regarding copyright ownership.
 * The ASF licenses this file to you under the Apache License, Version 2.0
 * (the "License"); you may not use this file except in compliance with
 * the License.  You may obtain a copy of the License at
 *
 * http://www.apache.org/licenses/LICENSE-2.0
 *
 * Unless required by applicable law or agreed to in writing, software
 * distributed under the License is distributed on an "AS IS" BASIS,
 * WITHOUT WARRANTIES OR CONDITIONS OF ANY KIND, either express or implied.
 * See the License for the specific language governing permissions and
 * limitations under the License.
 */
A: "A"
ABS: "ABS"
ABSENT: "ABSENT"
ABSOLUTE: "ABSOLUTE"
ACTION: "ACTION"
ADA: "ADA"
ADD: "ADD"
ADMIN: "ADMIN"
AFTER: "AFTER"
ALL: "ALL"
ALLOCATE: "ALLOCATE"
ALLOW: "ALLOW"
ALTER: "ALTER"
ALWAYS: "ALWAYS"
AND: "AND"
ANY: "ANY"
APPLY: "APPLY"
ARE: "ARE"
ARRAY: "ARRAY"
ARRAY_MAX_CARDINALITY: "ARRAY_MAX_CARDINALITY"
AS: "AS"
ASC: "ASC"
ASENSITIVE: "ASENSITIVE"
ASSERTION: "ASSERTION"
ASSIGNMENT: "ASSIGNMENT"
ASYMMETRIC: "ASYMMETRIC"
AT: "AT"
ATOMIC: "ATOMIC"
ATTRIBUTE: "ATTRIBUTE"
ATTRIBUTES: "ATTRIBUTES"
AUTHORIZATION: "AUTHORIZATION"
AVG: "AVG"
BEFORE: "BEFORE"
BEGIN: "BEGIN"
BEGIN_FRAME: "BEGIN_FRAME"
BEGIN_PARTITION: "BEGIN_PARTITION"
BERNOULLI: "BERNOULLI"
BETWEEN: "BETWEEN"
BIGINT: "BIGINT"
BINARY: "BINARY"
BIT: "BIT"
BLOB: "BLOB"
BOOLEAN: "BOOLEAN"
BOTH: "BOTH"
BREADTH: "BREADTH"
BY: "BY"
C: "C"
CALL: "CALL"
CALLED: "CALLED"
CARDINALITY: "CARDINALITY"
CARET: "^"
CASCADE: "CASCADE"
CASCADED: "CASCADED"
CASE: "CASE"
CAST: "CAST"
CATALOG: "CATALOG"
CATALOG_NAME: "CATALOG_NAME"
CEIL: "CEIL"
CEILING: "CEILING"
CENTURY: "CENTURY"
CHAIN: "CHAIN"
CHAR: "CHAR"
CHARACTER: "CHARACTER"
CHARACTERISTICS: "CHARACTERISTICS"
CHARACTERS: "CHARACTERS"
CHARACTER_LENGTH: "CHARACTER_LENGTH"
CHARACTER_SET_CATALOG: "CHARACTER_SET_CATALOG"
CHARACTER_SET_NAME: "CHARACTER_SET_NAME"
CHARACTER_SET_SCHEMA: "CHARACTER_SET_SCHEMA"
CHAR_LENGTH: "CHAR_LENGTH"
CHECK: "CHECK"
CLASSIFIER: "CLASSIFIER"
CLASS_ORIGIN: "CLASS_ORIGIN"
CLOB: "CLOB"
CLOSE: "CLOSE"
COALESCE: "COALESCE"
COBOL: "COBOL"
COLLATE: "COLLATE"
COLLATION: "COLLATION"
COLLATION_CATALOG: "COLLATION_CATALOG"
COLLATION_NAME: "COLLATION_NAME"
COLLATION_SCHEMA: "COLLATION_SCHEMA"
COLLECT: "COLLECT"
COLON: ":"
COLUMN: "COLUMN"
COLUMN_NAME: "COLUMN_NAME"
COMMA: ","
COMMAND_FUNCTION: "COMMAND_FUNCTION"
COMMAND_FUNCTION_CODE: "COMMAND_FUNCTION_CODE"
COMMIT: "COMMIT"
COMMITTED: "COMMITTED"
CONCAT: "||"
CONDITION: "CONDITION"
CONDITIONAL: "CONDITIONAL"
CONDITION_NUMBER: "CONDITION_NUMBER"
CONNECT: "CONNECT"
CONNECTION: "CONNECTION"
CONNECTION_NAME: "CONNECTION_NAME"
CONSTRAINT: "CONSTRAINT"
CONSTRAINTS: "CONSTRAINTS"
CONSTRAINT_CATALOG: "CONSTRAINT_CATALOG"
CONSTRAINT_NAME: "CONSTRAINT_NAME"
CONSTRAINT_SCHEMA: "CONSTRAINT_SCHEMA"
CONSTRUCTOR: "CONSTRUCTOR"
CONTAINS: "CONTAINS"
CONTINUE: "CONTINUE"
CONVERT: "CONVERT"
CORR: "CORR"
CORRESPONDING: "CORRESPONDING"
COUNT: "COUNT"
COVAR_POP: "COVAR_POP"
COVAR_SAMP: "COVAR_SAMP"
CREATE: "CREATE"
CROSS: "CROSS"
CUBE: "CUBE"
CUME_DIST: "CUME_DIST"
CURRENT: "CURRENT"
CURRENT_CATALOG: "CURRENT_CATALOG"
CURRENT_DATE: "CURRENT_DATE"
CURRENT_DEFAULT_TRANSFORM_GROUP: "CURRENT_DEFAULT_TRANSFORM_GROUP"
CURRENT_PATH: "CURRENT_PATH"
CURRENT_ROLE: "CURRENT_ROLE"
CURRENT_ROW: "CURRENT_ROW"
CURRENT_SCHEMA: "CURRENT_SCHEMA"
CURRENT_TIME: "CURRENT_TIME"
CURRENT_TIMESTAMP: "CURRENT_TIMESTAMP"
CURRENT_TRANSFORM_GROUP_FOR_TYPE: "CURRENT_TRANSFORM_GROUP_FOR_TYPE"
CURRENT_USER: "CURRENT_USER"
CURSOR: "CURSOR"
CURSOR_NAME: "CURSOR_NAME"
CYCLE: "CYCLE"
DATA: "DATA"
DATABASE: "DATABASE"
DATE: "DATE"
DATETIME_INTERVAL_CODE: "DATETIME_INTERVAL_CODE"
DATETIME_INTERVAL_PRECISION: "DATETIME_INTERVAL_PRECISION"
DAY: "DAY"
DAYS: "DAYS"
DEALLOCATE: "DEALLOCATE"
DEC: "DEC"
DECADE: "DECADE"
DECIMAL: "DECIMAL"
DECLARE: "DECLARE"
DEFAULTS: "DEFAULTS"
DEFAULT_: "DEFAULT"
DEFERRABLE: "DEFERRABLE"
DEFERRED: "DEFERRED"
DEFINE: "DEFINE"
DEFINED: "DEFINED"
DEFINER: "DEFINER"
DEGREE: "DEGREE"
DELETE: "DELETE"
DENSE_RANK: "DENSE_RANK"
DEPTH: "DEPTH"
DEREF: "DEREF"
DERIVED: "DERIVED"
DESC: "DESC"
DESCRIBE: "DESCRIBE"
DESCRIPTION: "DESCRIPTION"
DESCRIPTOR: "DESCRIPTOR"
DETERMINISTIC: "DETERMINISTIC"
DIAGNOSTICS: "DIAGNOSTICS"
DISALLOW: "DISALLOW"
DISCONNECT: "DISCONNECT"
DISPATCH: "DISPATCH"
DISTINCT: "DISTINCT"
DOLLAR: "$"
DOMAIN: "DOMAIN"
DOT: "."
DOUBLE: "DOUBLE"
DOUBLE_PERIOD: ".."
DOUBLE_QUOTE: "\""
DOW: "DOW"
DOY: "DOY"
DROP: "DROP"
DYNAMIC: "DYNAMIC"
DYNAMIC_FUNCTION: "DYNAMIC_FUNCTION"
DYNAMIC_FUNCTION_CODE: "DYNAMIC_FUNCTION_CODE"
EACH: "EACH"
ELEMENT: "ELEMENT"
ELSE: "ELSE"
EMPTY: "EMPTY"
ENCODING: "ENCODING"
END: "END"
END_EXEC: "END-EXEC"
END_FRAME: "END_FRAME"
END_PARTITION: "END_PARTITION"
EPOCH: "EPOCH"
EQ: "="
EQUALS: "EQUALS"
ERROR: "ERROR"
ESCAPE: "ESCAPE"
EVERY: "EVERY"
EXCEPT: "EXCEPT"
EXCEPTION: "EXCEPTION"
EXCLUDE: "EXCLUDE"
EXCLUDING: "EXCLUDING"
EXEC: "EXEC"
EXECUTE: "EXECUTE"
EXISTS: "EXISTS"
EXP: "EXP"
EXPLAIN: "EXPLAIN"
EXTEND: "EXTEND"
EXTERNAL: "EXTERNAL"
EXTRACT: "EXTRACT"
FALSE: "FALSE"
FETCH: "FETCH"
FILTER: "FILTER"
FINAL: "FINAL"
FIRST: "FIRST"
FIRST_VALUE: "FIRST_VALUE"
FLOAT: "FLOAT"
FLOOR: "FLOOR"
FOLLOWING: "FOLLOWING"
FOR: "FOR"
FOREIGN: "FOREIGN"
FORMAT: "FORMAT"
FORTRAN: "FORTRAN"
FOUND: "FOUND"
FRAC_SECOND: "FRAC_SECOND"
FRAME_ROW: "FRAME_ROW"
FREE: "FREE"
FROM: "FROM"
FULL: "FULL"
FUNCTION: "FUNCTION"
FUSION: "FUSION"
G: "G"
GE: ">="
GENERAL: "GENERAL"
GENERATED: "GENERATED"
GEOMETRY: "GEOMETRY"
GET: "GET"
GLOBAL: "GLOBAL"
GO: "GO"
GOTO: "GOTO"
GRANT: "GRANT"
GRANTED: "GRANTED"
GROUP: "GROUP"
GROUPING: "GROUPING"
GROUPS: "GROUPS"
GT: ">"
HAVING: "HAVING"
HIERARCHY: "HIERARCHY"
HOLD: "HOLD"
HOOK: "?"
HOP: "HOP"
HOUR: "HOUR"
HOURS: "HOURS"
IDENTITY: "IDENTITY"
IGNORE: "IGNORE"
IMMEDIATE: "IMMEDIATE"
IMMEDIATELY: "IMMEDIATELY"
IMPLEMENTATION: "IMPLEMENTATION"
IMPORT: "IMPORT"
IN: "IN"
INCLUDING: "INCLUDING"
INCREMENT: "INCREMENT"
INDICATOR: "INDICATOR"
INITIAL: "INITIAL"
INITIALLY: "INITIALLY"
INNER: "INNER"
INOUT: "INOUT"
INPUT: "INPUT"
INSENSITIVE: "INSENSITIVE"
INSERT: "INSERT"
INSTANCE: "INSTANCE"
INSTANTIABLE: "INSTANTIABLE"
INT: "INT"
INTEGER: "INTEGER"
INTERSECT: "INTERSECT"
INTERSECTION: "INTERSECTION"
INTERVAL: "INTERVAL"
INTO: "INTO"
INVOKER: "INVOKER"
IS: "IS"
ISODOW: "ISODOW"
ISOLATION: "ISOLATION"
ISOYEAR: "ISOYEAR"
JAVA: "JAVA"
JOIN: "JOIN"
JSON: "JSON"
JSON_ARRAY: "JSON_ARRAY"
JSON_ARRAYAGG: "JSON_ARRAYAGG"
JSON_EXISTS: "JSON_EXISTS"
JSON_OBJECT: "JSON_OBJECT"
JSON_OBJECTAGG: "JSON_OBJECTAGG"
JSON_QUERY: "JSON_QUERY"
JSON_VALUE: "JSON_VALUE"
K: "K"
KEY: "KEY"
KEY_MEMBER: "KEY_MEMBER"
KEY_TYPE: "KEY_TYPE"
LABEL: "LABEL"
LAG: "LAG"
LANGUAGE: "LANGUAGE"
LARGE: "LARGE"
LAST: "LAST"
LAST_VALUE: "LAST_VALUE"
LATERAL: "LATERAL"
LBRACE: "{"
LBRACE_D: "{" (" ")* ["d","D"]
LBRACE_FN: "{" (" ")* ["f","F"] ["n","N"]
LBRACE_T: "{" (" ")* ["t","T"]
LBRACE_TS: "{" (" ")* ["t","T"] ["s","S"]
LBRACKET: "["
LE: "<="
LEAD: "LEAD"
LEADING: "LEADING"
LEFT: "LEFT"
LENGTH: "LENGTH"
LEVEL: "LEVEL"
LIBRARY: "LIBRARY"
LIKE: "LIKE"
LIKE_REGEX: "LIKE_REGEX"
LIMIT: "LIMIT"
LN: "LN"
LOCAL: "LOCAL"
LOCALTIME: "LOCALTIME"
LOCALTIMESTAMP: "LOCALTIMESTAMP"
LOCATOR: "LOCATOR"
LOWER: "LOWER"
LPAREN: "("
LT: "<"
M: "M"
MAP: "MAP"
MATCH: "MATCH"
MATCHED: "MATCHED"
MATCHES: "MATCHES"
MATCH_NUMBER: "MATCH_NUMBER"
MATCH_RECOGNIZE: "MATCH_RECOGNIZE"
MAX: "MAX"
MAXVALUE: "MAXVALUE"
MEASURES: "MEASURES"
MEMBER: "MEMBER"
MERGE: "MERGE"
MESSAGE_LENGTH: "MESSAGE_LENGTH"
MESSAGE_OCTET_LENGTH: "MESSAGE_OCTET_LENGTH"
MESSAGE_TEXT: "MESSAGE_TEXT"
METHOD: "METHOD"
MICROSECOND: "MICROSECOND"
MILLENNIUM: "MILLENNIUM"
MILLISECOND: "MILLISECOND"
MIN: "MIN"
MINUS: "-"
MINUTE: "MINUTE"
MINUTES: "MINUTES"
MINVALUE: "MINVALUE"
MOD: "MOD"
MODIFIES: "MODIFIES"
MODULE: "MODULE"
MONTH: "MONTH"
MONTHS: "MONTHS"
MORE_: "MORE"
MULTISET: "MULTISET"
MUMPS: "MUMPS"
NAME: "NAME"
NAMED_ARGUMENT_ASSIGNMENT: "=>"
NAMES: "NAMES"
NANOSECOND: "NANOSECOND"
NATIONAL: "NATIONAL"
NATURAL: "NATURAL"
NCHAR: "NCHAR"
NCLOB: "NCLOB"
NE2: "!="
NE: "<>"
NESTING: "NESTING"
NEW: "NEW"
NEXT: "NEXT"
NO: "NO"
NONE: "NONE"
NORMALIZE: "NORMALIZE"
NORMALIZED: "NORMALIZED"
NOT: "NOT"
NTH_VALUE: "NTH_VALUE"
NTILE: "NTILE"
NULL: "NULL"
NULLABLE: "NULLABLE"
NULLIF: "NULLIF"
NULLS: "NULLS"
NUMBER: "NUMBER"
NUMERIC: "NUMERIC"
OBJECT: "OBJECT"
OCCURRENCES_REGEX: "OCCURRENCES_REGEX"
OCTETS: "OCTETS"
OCTET_LENGTH: "OCTET_LENGTH"
OF: "OF"
OFFSET: "OFFSET"
OLD: "OLD"
OMIT: "OMIT"
ON: "ON"
ONE: "ONE"
ONLY: "ONLY"
OPEN: "OPEN"
OPTION: "OPTION"
OPTIONS: "OPTIONS"
OR: "OR"
ORDER: "ORDER"
ORDERING: "ORDERING"
ORDINALITY: "ORDINALITY"
OTHERS: "OTHERS"
OUT: "OUT"
OUTER: "OUTER"
OUTPUT: "OUTPUT"
OVER: "OVER"
OVERLAPS: "OVERLAPS"
OVERLAY: "OVERLAY"
OVERRIDING: "OVERRIDING"
PAD: "PAD"
PARAMETER: "PARAMETER"
PARAMETER_MODE: "PARAMETER_MODE"
PARAMETER_NAME: "PARAMETER_NAME"
PARAMETER_ORDINAL_POSITION: "PARAMETER_ORDINAL_POSITION"
PARAMETER_SPECIFIC_CATALOG: "PARAMETER_SPECIFIC_CATALOG"
PARAMETER_SPECIFIC_NAME: "PARAMETER_SPECIFIC_NAME"
PARAMETER_SPECIFIC_SCHEMA: "PARAMETER_SPECIFIC_SCHEMA"
PARTIAL: "PARTIAL"
PARTITION: "PARTITION"
PASCAL: "PASCAL"
PASSING: "PASSING"
PASSTHROUGH: "PASSTHROUGH"
PAST: "PAST"
PATH: "PATH"
PATTERN: "PATTERN"
PER: "PER"
PERCENT: "PERCENT"
PERCENTILE_CONT: "PERCENTILE_CONT"
PERCENTILE_DISC: "PERCENTILE_DISC"
PERCENT_RANK: "PERCENT_RANK"
PERCENT_REMAINDER: "%"
PERIOD: "PERIOD"
PERMUTE: "PERMUTE"
PLACING: "PLACING"
PLAN: "PLAN"
PLI: "PLI"
PLUS: "+"
PORTION: "PORTION"
POSITION: "POSITION"
POSITION_REGEX: "POSITION_REGEX"
POWER: "POWER"
PRECEDES: "PRECEDES"
PRECEDING: "PRECEDING"
PRECISION: "PRECISION"
PREPARE: "PREPARE"
PRESERVE: "PRESERVE"
PREV: "PREV"
PRIMARY: "PRIMARY"
PRIOR: "PRIOR"
PRIVILEGES: "PRIVILEGES"
PROCEDURE: "PROCEDURE"
PUBLIC: "PUBLIC"
QUARTER: "QUARTER"
QUOTE: "'"
RANGE: "RANGE"
RANK: "RANK"
RBRACE: "}"
RBRACKET: "]"
READ: "READ"
READS: "READS"
REAL: "REAL"
RECURSIVE: "RECURSIVE"
REF: "REF"
REFERENCES: "REFERENCES"
REFERENCING: "REFERENCING"
REGR_AVGX: "REGR_AVGX"
REGR_AVGY: "REGR_AVGY"
REGR_COUNT: "REGR_COUNT"
REGR_INTERCEPT: "REGR_INTERCEPT"
REGR_R2: "REGR_R2"
REGR_SLOPE: "REGR_SLOPE"
REGR_SXX: "REGR_SXX"
REGR_SXY: "REGR_SXY"
REGR_SYY: "REGR_SYY"
RELATIVE: "RELATIVE"
RELEASE: "RELEASE"
REPEATABLE: "REPEATABLE"
REPLACE: "REPLACE"
RESET: "RESET"
RESPECT: "RESPECT"
RESTART: "RESTART"
RESTRICT: "RESTRICT"
RESULT: "RESULT"
RETURN: "RETURN"
RETURNED_CARDINALITY: "RETURNED_CARDINALITY"
RETURNED_LENGTH: "RETURNED_LENGTH"
RETURNED_OCTET_LENGTH: "RETURNED_OCTET_LENGTH"
RETURNED_SQLSTATE: "RETURNED_SQLSTATE"
RETURNING: "RETURNING"
RETURNS: "RETURNS"
REVOKE: "REVOKE"
RIGHT: "RIGHT"
ROLE: "ROLE"
ROLLBACK: "ROLLBACK"
ROLLUP: "ROLLUP"
ROUTINE: "ROUTINE"
ROUTINE_CATALOG: "ROUTINE_CATALOG"
ROUTINE_NAME: "ROUTINE_NAME"
ROUTINE_SCHEMA: "ROUTINE_SCHEMA"
ROW: "ROW"
ROWS: "ROWS"
ROW_COUNT: "ROW_COUNT"
ROW_NUMBER: "ROW_NUMBER"
RPAREN: ")"
RUNNING: "RUNNING"
SAVEPOINT: "SAVEPOINT"
SCALAR: "SCALAR"
SCALE: "SCALE"
SCHEMA: "SCHEMA"
SCHEMA_NAME: "SCHEMA_NAME"
SCOPE: "SCOPE"
SCOPE_CATALOGS: "SCOPE_CATALOGS"
SCOPE_NAME: "SCOPE_NAME"
SCOPE_SCHEMA: "SCOPE_SCHEMA"
SCROLL: "SCROLL"
SEARCH: "SEARCH"
SECOND: "SECOND"
SECONDS: "SECONDS"
SECTION: "SECTION"
SECURITY: "SECURITY"
SEEK: "SEEK"
SELECT: "SELECT"
SELF: "SELF"
SEMICOLON: ";"
SENSITIVE: "SENSITIVE"
SEQUENCE: "SEQUENCE"
SERIALIZABLE: "SERIALIZABLE"
SERVER: "SERVER"
SERVER_NAME: "SERVER_NAME"
SESSION: "SESSION"
SESSION_USER: "SESSION_USER"
SET: "SET"
SETS: "SETS"
SET_MINUS: "MINUS"
SHOW: "SHOW"
SIMILAR: "SIMILAR"
SIMPLE: "SIMPLE"
SIZE: "SIZE"
SKIP_: "SKIP"
SLASH: "/"
SMALLINT: "SMALLINT"
SOME: "SOME"
SOURCE: "SOURCE"
SPACE: "SPACE"
SPECIFIC: "SPECIFIC"
SPECIFICTYPE: "SPECIFICTYPE"
SPECIFIC_NAME: "SPECIFIC_NAME"
SQL: "SQL"
SQLEXCEPTION: "SQLEXCEPTION"
SQLSTATE: "SQLSTATE"
SQLWARNING: "SQLWARNING"
SQL_BIGINT: "SQL_BIGINT"
SQL_BINARY: "SQL_BINARY"
SQL_BIT: "SQL_BIT"
SQL_BLOB: "SQL_BLOB"
SQL_BOOLEAN: "SQL_BOOLEAN"
SQL_CHAR: "SQL_CHAR"
SQL_CLOB: "SQL_CLOB"
SQL_DATE: "SQL_DATE"
SQL_DECIMAL: "SQL_DECIMAL"
SQL_DOUBLE: "SQL_DOUBLE"
SQL_FLOAT: "SQL_FLOAT"
SQL_INTEGER: "SQL_INTEGER"
SQL_INTERVAL_DAY: "SQL_INTERVAL_DAY"
SQL_INTERVAL_DAY_TO_HOUR: "SQL_INTERVAL_DAY_TO_HOUR"
SQL_INTERVAL_DAY_TO_MINUTE: "SQL_INTERVAL_DAY_TO_MINUTE"
SQL_INTERVAL_DAY_TO_SECOND: "SQL_INTERVAL_DAY_TO_SECOND"
SQL_INTERVAL_HOUR: "SQL_INTERVAL_HOUR"
SQL_INTERVAL_HOUR_TO_MINUTE: "SQL_INTERVAL_HOUR_TO_MINUTE"
SQL_INTERVAL_HOUR_TO_SECOND: "SQL_INTERVAL_HOUR_TO_SECOND"
SQL_INTERVAL_MINUTE: "SQL_INTERVAL_MINUTE"
SQL_INTERVAL_MINUTE_TO_SECOND: "SQL_INTERVAL_MINUTE_TO_SECOND"
SQL_INTERVAL_MONTH: "SQL_INTERVAL_MONTH"
SQL_INTERVAL_SECOND: "SQL_INTERVAL_SECOND"
SQL_INTERVAL_YEAR: "SQL_INTERVAL_YEAR"
SQL_INTERVAL_YEAR_TO_MONTH: "SQL_INTERVAL_YEAR_TO_MONTH"
SQL_LONGVARBINARY: "SQL_LONGVARBINARY"
SQL_LONGVARCHAR: "SQL_LONGVARCHAR"
SQL_LONGVARNCHAR: "SQL_LONGVARNCHAR"
SQL_NCHAR: "SQL_NCHAR"
SQL_NCLOB: "SQL_NCLOB"
SQL_NUMERIC: "SQL_NUMERIC"
SQL_NVARCHAR: "SQL_NVARCHAR"
SQL_REAL: "SQL_REAL"
SQL_SMALLINT: "SQL_SMALLINT"
SQL_TIME: "SQL_TIME"
SQL_TIMESTAMP: "SQL_TIMESTAMP"
SQL_TINYINT: "SQL_TINYINT"
SQL_TSI_DAY: "SQL_TSI_DAY"
SQL_TSI_FRAC_SECOND: "SQL_TSI_FRAC_SECOND"
SQL_TSI_HOUR: "SQL_TSI_HOUR"
SQL_TSI_MICROSECOND: "SQL_TSI_MICROSECOND"
SQL_TSI_MINUTE: "SQL_TSI_MINUTE"
SQL_TSI_MONTH: "SQL_TSI_MONTH"
SQL_TSI_QUARTER: "SQL_TSI_QUARTER"
SQL_TSI_SECOND: "SQL_TSI_SECOND"
SQL_TSI_WEEK: "SQL_TSI_WEEK"
SQL_TSI_YEAR: "SQL_TSI_YEAR"
SQL_VARBINARY: "SQL_VARBINARY"
SQL_VARCHAR: "SQL_VARCHAR"
SQRT: "SQRT"
STAR: "*"
START: "START"
STATE: "STATE"
STATEMENT: "STATEMENT"
STATIC: "STATIC"
STDDEV_POP: "STDDEV_POP"
STDDEV_SAMP: "STDDEV_SAMP"
STREAM: "STREAM"
STRUCTURE: "STRUCTURE"
STYLE: "STYLE"
SUBCLASS_ORIGIN: "SUBCLASS_ORIGIN"
SUBMULTISET: "SUBMULTISET"
SUBSET: "SUBSET"
SUBSTITUTE: "SUBSTITUTE"
SUBSTRING: "SUBSTRING"
SUBSTRING_REGEX: "SUBSTRING_REGEX"
SUCCEEDS: "SUCCEEDS"
SUM: "SUM"
SYMMETRIC: "SYMMETRIC"
SYSTEM: "SYSTEM"
SYSTEM_TIME: "SYSTEM_TIME"
SYSTEM_USER: "SYSTEM_USER"
TABLE: "TABLE"
TABLESAMPLE: "TABLESAMPLE"
TABLE_NAME: "TABLE_NAME"
TEMPORARY: "TEMPORARY"
THEN: "THEN"
TIES: "TIES"
TIME: "TIME"
TIMESTAMP: "TIMESTAMP"
TIMESTAMPADD: "TIMESTAMPADD"
TIMESTAMPDIFF: "TIMESTAMPDIFF"
TIMEZONE_HOUR: "TIMEZONE_HOUR"
TIMEZONE_MINUTE: "TIMEZONE_MINUTE"
TINYINT: "TINYINT"
TO: "TO"
TOP_LEVEL_COUNT: "TOP_LEVEL_COUNT"
TRAILING: "TRAILING"
TRANSACTION: "TRANSACTION"
TRANSACTIONS_ACTIVE: "TRANSACTIONS_ACTIVE"
TRANSACTIONS_COMMITTED: "TRANSACTIONS_COMMITTED"
TRANSACTIONS_ROLLED_BACK: "TRANSACTIONS_ROLLED_BACK"
TRANSFORM: "TRANSFORM"
TRANSFORMS: "TRANSFORMS"
TRANSLATE: "TRANSLATE"
TRANSLATE_REGEX: "TRANSLATE_REGEX"
TRANSLATION: "TRANSLATION"
TREAT: "TREAT"
TRIGGER: "TRIGGER"
TRIGGER_CATALOG: "TRIGGER_CATALOG"
TRIGGER_NAME: "TRIGGER_NAME"
TRIGGER_SCHEMA: "TRIGGER_SCHEMA"
TRIM: "TRIM"
TRIM_ARRAY: "TRIM_ARRAY"
TRUE: "TRUE"
TRUNCATE: "TRUNCATE"
TUMBLE: "TUMBLE"
TYPE: "TYPE"
UESCAPE: "UESCAPE"
UNBOUNDED: "UNBOUNDED"
UNCOMMITTED: "UNCOMMITTED"
UNCONDITIONAL: "UNCONDITIONAL"
UNDER: "UNDER"
UNION: "UNION"
UNIQUE: "UNIQUE"
UNKNOWN: "UNKNOWN"
UNNAMED: "UNNAMED"
UNNEST: "UNNEST"
UPDATE: "UPDATE"
UPPER: "UPPER"
UPSERT: "UPSERT"
USAGE: "USAGE"
USER: "USER"
USER_DEFINED_TYPE_CATALOG: "USER_DEFINED_TYPE_CATALOG"
USER_DEFINED_TYPE_CODE: "USER_DEFINED_TYPE_CODE"
USER_DEFINED_TYPE_NAME: "USER_DEFINED_TYPE_NAME"
USER_DEFINED_TYPE_SCHEMA: "USER_DEFINED_TYPE_SCHEMA"
USING: "USING"
UTF16: "UTF16"
UTF32: "UTF32"
UTF8: "UTF8"
VALUE: "VALUE"
VALUES: "VALUES"
VALUE_OF: "VALUE_OF"
VARBINARY: "VARBINARY"
VARCHAR: "VARCHAR"
VARYING: "VARYING"
VAR_POP: "VAR_POP"
VAR_SAMP: "VAR_SAMP"
VERSION: "VERSION"
VERSIONING: "VERSIONING"
VERTICAL_BAR: "|"
VIEW: "VIEW"
WEEK: "WEEK"
WHEN: "WHEN"
WHENEVER: "WHENEVER"
WHERE: "WHERE"
WIDTH_BUCKET: "WIDTH_BUCKET"
WINDOW: "WINDOW"
WITH: "WITH"
WITHIN: "WITHIN"
WITHOUT: "WITHOUT"
WORK: "WORK"
WRAPPER: "WRAPPER"
WRITE: "WRITE"
XML: "XML"
YEAR: "YEAR"
YEARS: "YEARS"
ZONE: "ZONE"
